


NO ./assets/backroom.xpm
SO assets/backroom.xpm
WE assets/backroom.xpm

     

 
EA assets/backroom.xpm


F 100,200,10

C 120,148,0









        1111111111111111111111111
11111111100000000110000000010001
        1011000001000100000000001
        100100000100000000000011
111111111011000000000100000000001111111111
100000000011000000000000000111111
11110000000000000000000000001
1111011111110000000000000001
1100001     10011100000000001
100000111111100011000111111111
1000000000000000000100000000111
11000001110101011111000001W0101
11110001 1110101 10100000000111
11111111 1111111 11111111111111