


NO ./assets/backroom.xpm
SO assets/backroom.xpm
WE assets/backroom.xpm

     

 
EA assets/backroom.xpm


F       0,   255,    0

C       255,   0,    0








111111111
110W011
1100011
111111111