NO ./assets/edna_sorgelsen.xpm
SO assets/mademoiselle_boop.xpm
WE assets/drag_couenne.xpm
EA assets/peach.xpm

F 200,0,255
C 255,0,140

11111111111111111111
100000000S0000000001
10100000000000000101
10000000000000000001
10001000000000010001
10000000000000000001
10000010000001000001
10000000000000000001
10000000100100000001
10000000000000000001
10000000000000000001
10000000100100000001
10000000000000000001
10000010000001000001
10000000000000000001
10001000000000010001
10000000000000000001
10100000000000000101
10000000000000000001
11111111111111111111